111111111
100100001
10C1C0001
100100E01
10P000001
111111111
