111111111
110100001
1101C0E01
10P000001
100100C01
111111111