111111111111
100000000001
100CC00CC001
100CC00CC001
10000CC00001
1000CCCC0001
1000CCCC0001
10P0C00C0E01
100000000001
111111111111
