1111111111
1000000001
10EE00EE01
10EE00EE01
1000EE0001
100EEEE001
100EEEE001
100E00E001
1000000001
1111111111