111111111
11C100001
11E100C01
10000P001
100100C1
111111111