111111111
11C100001
11010C001
10000P001
1E0100001
111111111