111111111
11C100001
1101C0001
100000E01
10P100001
111111111