111111111111
100000000001
100EE00EE001
100EE00EE001
10000EE00001
1000EEEE0001
10C0EEEE0001
10P0E00E0001
100000000001
111111111111
