111111111111
100000000001
100000000001
100000000001
10000C000E01
10C000000001
100000C00001
10P000000001
100000000001
111111111111
