111111111111
100000000001
11110C000001
10C000000001
10010C000E01
111100000001
100000C00001
10P000000001
100000000001
111111111111
