111111
1E0001
1C0001
101001
1P1001
111111